NO  ./textures/n_texture.xpm
SO  ./textures/s_texture.xpm
WE  ./textures/w_texture.xpm

EA ./textures/e_texture.xpm


F 227,100,0
C 125,30,0

 111
10001
10001
10001
10001
10001
10001
10001
10001
10001
10001
10001
10001
10001
10001
10001
10001
10001
10001
10001
10001
10001
10001
10001
10001
10001
10001
10001
10001
10N01
11111
 111