NO						./path_to_the_north_texture				
			SO ./path_to_the_south_texture


WE ./path_to_the_west_texture




			EA					 ./path_to_the_east_texture  
	





F 		220,     100,   30
			C		225,    30,       20  			
 111
 101
10001
10S01
10001
11111