NO						./path_to_the_north_texture				
			SO ./path_to_the_south_texture


WE ./path_to_the_west_texture




			EA					 ./path_to_the_east_texture  
	





F 		220,     100,   30
			C		225,    30,       20  			
                        111111111111111111
                1111111111110000000000001
                1000000000110000000000001
                1011000001110000001000001
                1001000000000000000000001
    1111111111111011000001110000000000001
    1000000000000000011101111001111111111      
    1111011111111101110000001000101
    1111011111111101110101001000111
    11000000110101011100000010001
    10000000000000001100000010001
    10000000000000001101010010001
    11000001110101011111011110S0111
    11110111111010110111101000111
    111111111111111111111111111