
NO 								./textures/n_texture.xpm

SO ./textures/s_texture.xpm															

WE 															./textures/w_texture.xpm



EA					 ./textures/e_texture.xpm
	



F 		20,     20,   20
			C		122,    110,       120  			
 111
 101
10001
10N01
10001
11111