NO  ./textures/n_texture.xpm
SO  ./textures/s_texture.xpm
WE  ./textures/w_texture.xpm
EA  ./textures/e_texture.xpm

F 220,100,0
C 125,30,0

            1111111111111111111111111
            1000000000110000000000001
            1011000001110000000000001
            1001000000000000000000001
1111111111111011000001110000000000001
1000000000000000011101111111111111111
11110111111111011100000010001
11110111111111011101010010001
11000000110101011100000010001
10000000000000001100000010001
10000000000000001101010010001
100000010101011111011110N0111
111100111110101111111010001
111111111111111111111111111